5
2 0 0 0 0
1 1 1 1 0
0 0 0 0 0
0 1 0 1 1
0 0 0 0 3
7
2 0 0 0 0 0 0
1 1 0 1 0 1 0
0 0 0 0 0 0 0
0 1 1 1 1 0 1
0 0 0 0 0 0 0
0 1 0 1 1 1 0
0 1 0 0 1 3 0
9
2 0 0 0 0 0 0 0 0
1 1 1 1 0 1 1 1 0
0 0 0 0 0 0 0 0 0
1 1 1 1 0 1 1 0 0
0 0 0 1 0 1 0 0 0
0 1 0 0 0 0 0 1 0
0 0 1 0 1 1 1 0 0
0 1 1 0 0 1 0 0 0
0 0 3 1 0 0 0 1 0